2222222222
2000000002
2000000002
2000000002
2000110002
2000110002
2000000002
2000000002
2000000002
2000000002
2000000002
2000000002
2000000002
2000000002
2000000002
2222222222